--------------------------------------------------------------------------------------------------------------------------------------------------------------------------------------------------------
--------------------------------------------------------------------------------------------------------------------------------------------------------------------------------------------------------
--------------------------------------------------------------------------------------------------------------------------------------------------------------------------------------------------------
------------S----S-------------------------S-S--------------------C-------------------------------------------------------------------------------------------------------------------------------------
---------------D----tt---tt--U--------------------D----------------------------------------------------------------------------------------------------------------------SCS-S2-------------------------
--------------------Tt---tt-----tt---%%%%%---------------S-S2SS-----------------------------------------------------------------------------------------------------------------------------------------
-SSSS---------------tt---tt--r--Tt---|||||----------------------------------------------------C---C--------------------------------------------------------------g------------------------%%---%%-------
------D-SSS%%%%%%%%%%%%%%%%%%%%%%%%%%|||||DDDD---DDDD---DD-------%%%%------------------------------------------------------------------------k-----------%%%%-SSS-------SSSSSSSSCS2S---SS-||---||-------
-----------|||||||||||||||||||||||||||||||-----------------------||||----------------------------------------------------------------S----%%%%-----------||||-----------------------------||---||-------
SSSSS------|||||||||||||||||||||||||||||||--------------%%%%--DDD||||DD---------------%%%%----g-----g--y----------------------------------||||-----------|k||---%%%%%---------------------||---||-------
---------D-%%%%%%%||||||||||||||||D|||||||-------%%%----||||-----||||-S-S-S-----------||||-%%%%%%%%%%%%%%%----------------SS----------g---|k||-------%%%%||||%%%|||||---------------------||---||-------
-----------|||||||||||||||||||||||-||||%%%%%%%---|||%---||||-----||||-----------D--%%%||||-|||||||||||||||---tt--SS2S-----------%%---%%%%%||||%%%%%%%||||||||||||||||----%%%%--%%%%%------||---||-------
%%%%-------|||||||||||||||||||||||-|||||||||||---||||---||||-----||||-r---r--------|||||||-||||||||tt|||||---tt----------tt-SSS-||---||||||||||||||||||||||||||||||||---%||||--|||||------||---||-------
||||%%--%%%%%|||||%%%%||%%%||%%||%%%%%%|||||||---||||---||||-----|||%%%%%%%%%---%%%|||||||-||||||||tt|||||#--tt------g---Tt-----||---||||||||||||||||||||||||||||||||---|||||--|||||------%%---%%F%%%%%%
||||||--||||||||||||||||||||||||||||||||||||||---||||---||||---S2SS||||||||||---||||||||||%||||||||%%|||||%%%%%%%%%%%%%%%%%%%%--||---||||||||||||||||||||||||||||||||---|||||--|||||------||---||%||||||
||||||--||||||||||||||||||||||||||||||||||||||---||||---||||-------||||||||||---||||||||||||||||||||||||||||||||||||||||||||||--||---||||||||||||||||||||||||||||||||---|||||--|||||------||---|||||||||

